 Kth-Based Questions by Topic:
ðŸ”¹ 1. Array
Question	Topic(s)
âœ… Find the Kth largest/smallest element in an array	Heap / QuickSelect / Sorting
âœ… Find the Kth missing positive number	Binary Search
âœ… Find the Kth non-repeating element	HashMap + Frequency
âœ… Find the Kth distinct element in an array	Set / Map

ðŸ”¹ 2. Sorting
Question	Topic(s)
âœ… Sort an array and return the Kth largest element	Sorting
âœ… Find the Kth smallest pair distance	Binary Search + Sorting
âœ… Return the Kth smallest number in a sorted matrix	Heap / Binary Search

ðŸ”¹ 3. Searching
Question	Topic(s)
âœ… Find the Kth missing number from a sorted array	Binary Search
âœ… Find Kth element in two sorted arrays (merge sorted arrays)	Binary Search
âœ… Find Kth positive integer missing from array	Prefix Sum / Binary Search

ðŸ”¹ 4. Linked List
Question	Topic(s)
âœ… Find the Kth node from end of a linked list	Two Pointers (Slow/Fast)
âœ… Reverse every K nodes in a linked list	Recursion + Linked List
âœ… Remove the Kth node from end	Dummy Node + Two Pointers

ðŸ”¹ 5. Heap / Priority Queue
Question	Topic(s)
âœ… Find the Kth largest/smallest element	Heap
âœ… Find K largest numbers in an array	Heap
âœ… K closest points to origin	Heap + Math
âœ… K frequent elements in an array	HashMap + Heap

ðŸ”¹ 6. String
Question	Topic(s)
âœ… Find the Kth non-repeating character	HashMap
âœ… Return the Kth substring in lexicographical order	Sorting
âœ… Find the Kth largest palindrome substring	String + Heap

ðŸ”¹ 7. Tree / Graph (For more advanced prep)
Question	Topic(s)
âœ… Find the Kth smallest element in BST	Inorder Traversal
âœ… Kth ancestor of a node in a tree	DFS / Binary Lifting
âœ… Kth farthest node in graph	Dijkstra / BFS

